# Special countries..
REB = "countries/Rebels.txt"
PIR = "countries/Pirates.txt"
NAT = "countries/Natives.txt"

#Vinland
ICE = "countries/Iceland.txt"
MAH = "countries/Mahican.txt" #recycled
MIK = "countries/Mikmaq.txt" #recycled
ABE = "countries/Abenaki.txt" #recycled
VIN = "countries/Vinland.txt"

#Cahokia
CAH = "countries/Cahokia.txt"
MMI = "countries/Miami.txt" #recycled
PAW = "countries/Pawnee.txt" #recycled
OSA = "countries/Osage.txt" #recycled
ILL = "countries/Illinewek.txt" #recycled
CHI = "countries/Chickasaw.txt" #recycled
CAD = "countries/Caddo.txt" #recycled

#other North America
SIO = "countries/Sioux.txt" #recycled as LAKOTA
ASI = "countries/Assiniboine.txt" #recycled as SANTEE
ARP = "countries/Arapaho.txt" #recycled as YANKTON
FOX = "countries/Fox.txt" #recycled
SHO = "countries/Shoshone.txt"#recycled
KIO = "countries/Kiowa.txt" #recycled as UTE
PIM = "countries/Pima.txt" #recycled
NAH = "countries/Navajo.txt" #recycled
PUE = "countries/Pueblo.txt" #recycled

#Caribs and Mexico
MAT = "countries/Matacumbe.txt"
KUN = "countries/Kuna.txt"
BOR = "countries/Boriken.txt"
JAM = "countries/Jamaica.txt"
CAJ = "countries/Guaney.txt"
CUL = "countries/Culiacan.txt"
ACA = "countries/Acaxee.txt"
COH = "countries/Cochimi.txt"
GIT = "countries/Gitmo.txt"
HAV = "countries/Havana.txt"
COB = "countries/Coba.txt"
BEL = "countries/Belize.txt"
MOC = "countries/Mochcouoh.txt"
CUI = "countries/Cuix.txt"
TAR = "countries/Tarascan.txt"
ZOT = "countries/Zotz.txt"
NMO = "countries/Kanbahlunmo.txt"
HUE = "countries/Huetamo.txt"
YUC = "countries/Yucatan.txt"
MEC = "countries/Chichimec.txt"
TOL = "countries/Tologalpa.txt"
TAG = "countries/Taguzgalpa.txt"

#Pacific
INC = "countries/Inca.txt"
NUK = "countries/Nukini.txt"
TEW = "countries/Waipounamu.txt"
NRJ = "countries/Ngarrindjeri.txt"
NOO = "countries/Noongar.txt"
TSI = "countries/Tasiman.txt"
NAN = "countries/Nan.txt"
BMA = "countries/Bei.txt"
DIM = "countries/Di.txt"
BJI = "countries/Baijinzhou.txt"

#Sudamericanos
WKA = "countries/Wanka.txt" #Recycled as CAMANA
CSU = "countries/Cusco.txt" #Recycled as QUERO
LIM = "countries/Lima.txt" #Lima culture union of sorts
CLA = "countries/Colla.txt" #Recycled
PCJ = "countries/Pacajes.txt" #Recycled
NZC = "countries/Nazca.txt" #union for Nazca states
CCQ = "countries/Calchaqui.txt" #Recycled as Cupisnique
CJA = "countries/Cajamarca.txt" #recycled
CSC = "countries/Chavinescara.txt" 
CCH = "countries/Chavinchuray.txt"
QTO = "countries/Quito.txt" #recycled
CHM = "countries/Chimu.txt" #recycled as north chimu
SCH = "countries/Southchimu.txt"
HJA = "countries/Huyla.txt" #recycled
HCV = "countries/Huancaviya.txt" 
CAY = "countries/Ucayali.txt"
JIV = "countries/Jivaro.txt"

#Britain
ALY = "countries/Albiyun.txt"
BRC = "countries/Bernicia.txt"
BRY = "countries/Brython.txt"
CTV = "countries/Catuvella.txt"
DRA = "countries/DalRaida.txt"
ELM = "countries/Elmet.txt"
GUB = "countries/Alba.txt"
IRE	= "countries/Ireland.txt"
RHE = "countries/Rheged.txt"

#Scandinavia
SWE	= "countries/Sweden.txt"
DAN	= "countries/Denmark.txt"
FIN	= "countries/Finland.txt"
GOT	= "countries/Gotland.txt"
NOR	= "countries/Norway.txt"
SHL	= "countries/Holstein.txt"
SCA	= "countries/Scandinavia.txt"

#Baltic
LAT = "countries/Latvia.txt"
EST = "countries/Estonia.txt"
YOT = "countries/Yotvingia.txt"
VAN = "countries/Vandal.txt"
GLI = "countries/Galindia.txt"

#Eastern Europe and Russia
KHZ = "countries/Khazar.txt"
ROX = "countries/Roxolani.txt"
CMN = "countries/Cuman.txt"
PEC = "countries/Pechenegs.txt"
SLA = "countries/Slavia.txt"
HOL = "countries/Holmguard.txt"
MAN = "countries/Mansi.txt"
MOK = "countries/Moksha.txt"
KOM = "countries/Komi.txt"

#Iberia
CIT = "countries/Citerior.txt"
GAL = "countries/Gallaecia.txt"
LUS = "countries/Lusitanya.txt"
NAV = "countries/Vasconia.txt"
SPA = "countries/Hispania.txt"
TRC = "countries/Tarraconensis.txt"
TRS = "countries/Tartessos.txt"

#Italy
ITA = "countries/Italya.txt"
ROM = "countries/Rome.txt"
SPQ = "countries/SPQR.txt"
PIL = "countries/Pilgrims.txt"
RHA = "countries/Rhaetia.txt"

#North Africa
ALG = "countries/Zenada.txt"
FZA = "countries/Fezzan.txt" #recycled from vanilla
GHD = "countries/Ghadames.txt" #recycled from vanilla
MOR = "countries/Mauretania.txt"
MZB = "countries/Mzab.txt" #recycled from vanilla
NUM = "countries/Numidia.txt"
QRT = "countries/Carthage.txt"
TGT = "countries/Touggourt.txt" #recycled from vanilla
UEG = "countries/Upperegypt.txt"
LEG = "countries/Loweregypt.txt"
ORO = "countries/Orossinas.txt"

#Hellenic League
ATH = "countries/Athens.txt"
BIT = "countries/Bithynia.txt"
CAR = "countries/Caria.txt"
CRN = "countries/Corinth.txt"
EPI = "countries/Epirus.txt"
LAR = "countries/Larissa.txt"
LES = "countries/Lesbos.txt"
LYD = "countries/Lydia.txt"
MAC = "countries/Macedonia.txt"
PHR = "countries/Phrygia.txt"
PON = "countries/Pontus.txt"
RHO = "countries/Rhodes.txt"
SPR = "countries/Sparta.txt"
SRC = "countries/Syracuse.txt"
THR = "countries/Thracia.txt"
TRO = "countries/Troy.txt"
TMK = "countries/Taurimark.txt"

#Other Greek and Minor Asian states
BYZ = "countries/ByzantineEmpire.txt"
CAP = "countries/Cappadocia.txt"
GRE = "countries/Greece.txt" #Greek culture union
AMI = "countries/AsiaMinor.txt" #Anatolian culture union

#Suomenusko
SAM = "countries/Sami.txt"

#West Germanics
FRK	= "countries/Frankreich.txt"
ANG	= "countries/Angleland.txt"
FRI	= "countries/Frisia.txt"
SAX	= "countries/Saxony.txt"
ALL = "countries/Allemannia.txt"
LOM = "countries/Lombardia.txt"
MRC	= "countries/Marcomannia.txt"

#Caucasian region
SCY = "countries/Scythia.txt"
SKR = "countries/Sakartvelo.txt"
TAM = "countries/Taman.txt"
SRV = "countries/Shirvanshah.txt" #recycled from yoghurt
CMG = "countries/Commagene.txt"
SOP = "countries/Sophene.txt"
ARM	= "countries/Armenia.txt"

#Karadicland
CRO	= "countries/Croatia.txt" #recycled from strawberry
GAU = "countries/Goths.txt" 
MON	= "countries/Montenegro.txt" #recycled from peanuts
HIS = "countries/Histri.txt"

#Levant
ANT = "countries/Antioch.txt"
BYB = "countries/Byblos.txt"
DMC = "countries/Damascus.txt"
PLM = "countries/Palmyra.txt"
TYR = "countries/Tyre.txt"
YIS = "countries/Judea.txt"
NAB = "countries/Nabatea.txt"

#Mesopotamia
ASY = "countries/Assyria.txt"
BAB = "countries/Babylon.txt"
LAK = "countries/Lakhmidia.txt"
PAP	= "countries/Papal.txt"
RBL = "countries/Arbela.txt"
SSA = "countries/Susa.txt"

#Araby
ADE	= "countries/Yemen.txt" #recycled from vanilla, Sheba
DHR = "countries/Hadhramaut.txt"
OMA	= "countries/Oman.txt" #recycled from chocolate, Oman
DMU = "countries/Dilmun.txt"
NAJ	= "countries/Najd.txt" #recycled from strawberry, Thamud
HED	= "countries/Hedjaz.txt" #recycled from hazelnut, Metopo
ALH	= "countries/Haasa.txt" #recycled from pistachio, Gerrha

#Persia
ECB = "countries/Ecbatana.txt"
ORG = "countries/Organa.txt"
RAT = "countries/Ararat.txt"
PER = "countries/Persia.txt"
CRM = "countries/Carmania.txt"
DRN = "countries/Drangiana.txt"
HYR = "countries/Hyrcania.txt"
PRT = "countries/Parthia.txt"

#Central Asia
BUK = "countries/Bukhara.txt"
NNI = "countries/Nanai.txt"
KYR = "countries/Kyrgyz.txt"
LAO = "countries/Liao.txt"
MRG = "countries/Margiana.txt"
OGH = "countries/Oghuz.txt"
SMK = "countries/Marakanda.txt"
SOG = "countries/Sogdiana.txt"
UYG = "countries/Uyghur.txt"

FER = "countries/Ferghana.txt"
BAC = "countries/Bactria.txt"
GED = "countries/Gedrosia.txt"
ARC = "countries/Arachosia.txt"
ARI = "countries/Ariaspi.txt"

HOT = "countries/Khotan.txt"
KCH = "countries/Kucha.txt"
KSG = "countries/Kashgar.txt"
QRQ = "countries/Qarqan.txt"
TRF = "countries/Turfan.txt"

#East and South Africa
MSY = "countries/Mosyllum.txt"
IRA = "countries/Raphta.txt"
PRA = "countries/Pirayye.txt"
PAN = "countries/Pano.txt"
SRN = "countries/Sarapion.txt"
NCN = "countries/Nicon.txt"
OPN = "countries/Opone.txt"
AZA = "countries/Azania.txt"
PNT = "countries/Puntland.txt"
DMT = "countries/Damot.txt"
CHS = "countries/Kush.txt"
FUR = "countries/Fur.txt"
SAN = "countries/Khoisan.txt"

#West Africa
MGA = "countries/Manga.txt"
AGS = "countries/Agisymba.txt"
KBO = "countries/KanemBornu.txt" #recycled from vanilla
GNA = "countries/Ghana.txt"
ZOE = "countries/Moshi.txt"
KTR = "countries/Kantor.txt"
UGU = "countries/Sibiridugu.txt"
JOL = "countries/Jolof.txt" #recycled from vanilla
BNM = "countries/Bonoman.txt"
WGD = "countries/Wagadugi.txt"
DEN = "countries/Dendi.txt"
BIL = "countries/Bilanga.txt"
WHY = "countries/Whydah.txt"
ISS = "countries/Issachar.txt"
GHA = "countries/Greatghana.txt" #union tag for post-ghana state, Old Ghana now Dagbon

#North India
BUC = "countries/Bucephala.txt"
GND = "countries/Gandhara.txt"
HRY = "countries/Haryana.txt"
IND = "countries/Indus.txt"
SAG = "countries/Sagala.txt"
SAT = "countries/Satnad.txt"
TAX = "countries/Taxila.txt"

CHB = "countries/Choban.txt"
HLT = "countries/Harlut.txt"
INJ = "countries/Inanji.txt"
KLI = "countries/Khilija.txt"
KRL = "countries/Karluk.txt"

KSH = "countries/Kashmir.txt"
NPL	= "countries/Nepal.txt"

#West India
AUR = "countries/Aursisthan.txt" 	
DWA = "countries/Dwaraka.txt"
JAS = "countries/Jasi.txt"
NBR = "countries/Nabradia.txt" 	
XII = "countries/Dalmasca.txt" 	
YUN = "countries/Yunasthan.txt"

#East India
BOF = "countries/Anga.txt"
GAN = "countries/Gangaridai.txt"
KAL = "countries/Kalinga.txt"
KMA = "countries/Kamarupa.txt"
KTE = "countries/Kathe.txt"
MGH = "countries/Magadha.txt"
MIZ = "countries/Mizoram.txt"
PNR = "countries/Pundra.txt"
POG = "countries/Pong.txt"
SUH = "countries/Suhma.txt"
VNG = "countries/Vanga.txt"

#Central India
ASM = "countries/Ashmaka.txt" #Maharashtra union
GDW = "countries/Gondwana.txt"
CHN = "countries/Chauhan.txt"
KNK = "countries/Konkan.txt"
PRH = "countries/Parihar.txt"
RED = "countries/Reddy.txt"
SOL = "countries/Solanki.txt"
YAD = "countries/Yadava.txt"

#South India
CER = "countries/Chera.txt"
COA = "countries/Chola.txt"
KER = "countries/Kerala.txt"
KRN = "countries/Karnataka.txt"
PDY = "countries/Pandya.txt"

#Mainland SE Asia
CHA	= "countries/Champa.txt"
KEN = "countries/Kengtung.txt"
KHM	= "countries/Khmer.txt"
KSE = "countries/Ksetra.txt"
LNG = "countries/Luang.txt"
MGL = "countries/Manglon.txt"
YAI = "countries/Yai.txt"

#Reusland
KED = "countries/Kedah.txt"
KLN = "countries/Kelantan.txt"
LGK = "countries/Langkasuka.txt"
PHG = "countries/Pahang.txt"
TSK = "countries/Temasek.txt"

ANK = "countries/Angkola.txt"
DRY = "countries/Dharmasraya.txt"
PLB = "countries/Palembang.txt"
YAV = "countries/Yavadvipa.txt" #Sumatra - I f'ed the names

JNG = "countries/Janggala.txt"
MTR	= "countries/Mataram.txt"
SNG = "countries/Singhasari.txt"
SUN = "countries/Sunda.txt"

BEI	= "countries/Brunei.txt"
KLM = "countries/Kalimantan.txt"
KUT = "countries/Kutai.txt"

BLI	= "countries/Bali.txt"

#Tibet
TIB	= "countries/Tibet.txt"
UTS = "countries/Utsang.txt"
KAM = "countries/Mdokhams.txt"
GUG = "countries/Guge.txt"

#South China
GYT = "countries/GyongTsrag.txt"
MGC = "countries/MengChu.txt"
MYU = "countries/Minyue.txt"
NYU = "countries/Nanyue.txt"
SHU = "countries/Shu.txt"
TNH = "countries/Tuunghai.txt"
XIE = "countries/Xie.txt"

#Chinese "Shogunate"
CHX = "countries/Huaxia.txt"
CGO = "countries/Gao.txt"
CJG = "countries/Jiang.txt"
CLO = "countries/Luo.txt"
CNI = "countries/Nei.txt"
CPG = "countries/Ping.txt"
CYE = "countries/Ye.txt"

#North China
EVE = "countries/Evenkil.txt"
MAG = "countries/Magyar.txt"
SSH = "countries/Sushen.txt"
YUE = "countries/Yueban.txt"

#Korea
BKJ = "countries/Baekje.txt"
BLH = "countries/Balhae.txt"
GOG = "countries/Goguryeo.txt"
SLL = "countries/Silla.txt"
XBI = "countries/Syanbi.txt"

#grorious nippon
HTA = "countries/Hata.txt"
JBA = "countries/Baraku.txt"
JHI = "countries/Hinomoto.txt"
JKU = "countries/Kuroba.txt"
JMI = "countries/Mitsukoshi.txt"
JYA = "countries/Yamato.txt"
HKI = "countries/Hitakami.txt"

#ABOVE THIS LINE IS GREECEMOD STUFF
#BELOW THIS LINE IS OLD COUNTRIES

#Balkans are partly cleansed
ALB	= "countries/Albania.txt"
CEP	= "countries/Corfu.txt"
CRT	= "countries/Crete.txt"
CYP	= "countries/Cyprus.txt"
RAG	= "countries/Ragusa.txt"

#British Isles are partly cleansed - union tags?
ENG	= "countries/England.txt"
SCO	= "countries/Scotland.txt"
GBR	= "countries/GreatBritain.txt"

#Colonies
BRZ	= "countries/Brazil.txt"
CAN	= "countries/Canada.txt"
CHL	= "countries/Chile.txt"
COL	= "countries/Colombia.txt"
HAT	= "countries/Haiti.txt"
LAP	= "countries/LaPlata.txt"
LOU	= "countries/Louisiana.txt"
MEX	= "countries/Mexico.txt"
PEU	= "countries/Peru.txt"
PRG	= "countries/Paraguay.txt"
QUE	= "countries/Quebec.txt"
CAM	= "countries/UPCA.txt"
USA	= "countries/USA.txt"
VNZ	= "countries/Venezuela.txt"

#Eastern Europe
DNZ	= "countries/Danzig.txt"
KRA	= "countries/Krakow.txt"
LIT	= "countries/Lithuania.txt"
LIV	= "countries/LivonianOrder.txt"
MAZ	= "countries/Mazovia.txt"
POL	= "countries/Poland.txt"
PRU	= "countries/Prussia.txt"
KUR	= "countries/Kurland.txt"
RIG	= "countries/Riga.txt"
TEU	= "countries/Teutonicorder.txt"
PLC = "countries/TheCommonwealth.txt"
VOL	= "countries/Volyn.txt"
KIE	= "countries/Kiev.txt"
CHR	= "countries/Chernigov.txt"

#France 
ALE = "countries/Alencon.txt"
ALS	= "countries/Alsace.txt"
AMG	= "countries/Armagnac.txt"
AUV	= "countries/Auvergne.txt"
AVI	= "countries/Avignon.txt"
BOU	= "countries/Bourbonnais.txt"
BRI	= "countries/Brittany.txt"
BUR	= "countries/Burgundy.txt"
CHP	= "countries/Champagne.txt"
COR	= "countries/Corsica.txt"
DAU	= "countries/Dauphine.txt"
FOI	= "countries/Foix.txt"
FRA	= "countries/France.txt"
GUY	= "countries/Guyenne.txt"
NEV	= "countries/Nevers.txt"
NRM	= "countries/Normandy.txt"
ORL	= "countries/Orleans.txt"
PRO	= "countries/Provence.txt"
RFR	= "countries/RevolutionaryFrance.txt"
SPI	= "countries/SardiniaPiedmont.txt"
TOU	= "countries/Toulouse.txt"
BER	= "countries/Berry.txt"
	
#HRE is cleansed
GER	= "countries/Germany.txt"
HLR = "countries/HolyRomanEmpire.txt"
	
#Spain is cleansed

#Italy is cleansed
VEN	= "countries/Venice.txt"

#Low Countries is cleansed

#Russia is cleansed
SIB	= "countries/Sibir.txt"
PRM = "countries/Perm.txt"
BSH	= "countries/Bashkiria.txt"

#Arabia	

SHR	= "countries/Sharjah.txt"
		
#Asia Minor is cleansed
IRQ	= "countries/Iraq.txt"
SYR	= "countries/Syria.txt"
	
#Maghreb
MAM	= "countries/Burgi.txt"
TRP	= "countries/Tripoli.txt"
EGY = "countries/Egypt.txt"

#Central Asia
KZH	= "countries/Kazakh.txt"
KHI	= "countries/Khiva.txt"
SHY	= "countries/Shaybanid.txt"
KOK	= "countries/Kokkand.txt"

#Persia	is cleansed

#Americas
AZT = "countries/Aztec.txt"
CHE = "countries/Cherokee.txt"
CRE = "countries/Creek.txt"
HUR = "countries/Huron.txt"

IRO = "countries/Iroquois.txt"
MAY = "countries/Maya.txt"
SHA = "countries/Shawnee.txt"
ZAP = "countries/Zapotec.txt"

#Africa
ASH = "countries/Ashanti.txt"
BEN = "countries/Benin.txt"
ETH = "countries/Ethiopia.txt"
KON = "countries/Kongo.txt"
MAL = "countries/Mali.txt"
NUB = "countries/Funj.txt"
SON = "countries/Songhai.txt"
ZAN = "countries/Swahili.txt"
ZIM = "countries/Mutapa.txt"
ADA = "countries/Adal.txt"
HAU = "countries/Hausa.txt"
LOA = "countries/Loango.txt"
OYO = "countries/Oyo.txt"
SOF = "countries/Sofala.txt"
SOK = "countries/Sokoto.txt"

SFA = "countries/SofalaSwa.txt"
MBA = "countries/Mombasa.txt"
MLI = "countries/Malindi.txt"
AJU = "countries/Ajuuraan.txt"
MDI = "countries/Mogadishu.txt"

#East African Additions

AFA = "countries/Afar.txt"
ALO = "countries/Alodia.txt"
DAR = "countries/Darfur.txt"
GLE = "countries/Geledi.txt"
HAR = "countries/Harar.txt"
HOB = "countries/Hobyo.txt"
KAF = "countries/Kaffa.txt"
MED = "countries/Medri Bahri.txt"
MJE = "countries/Majeerteen.txt"
MRE = "countries/Marehan.txt"
PTE = "countries/Pate.txt"
WAR = "countries/Warsangali.txt"

#Far East
ANN	= "countries/Annam.txt"
ARK	= "countries/Arakan.txt"
ATJ	= "countries/Atjeh.txt"
AYU	= "countries/Ayutthaya.txt"
BAN	= "countries/Banten.txt"
CHK	= "countries/Champassak.txt"
DAI	= "countries/DaiViet.txt"
JAP	= "countries/Japan.txt"

#Daimyos hahahahaha what daimyos

KOR	= "countries/Korea.txt"
MCH	= "countries/Manchu.txt"
MKS	= "countries/Makassar.txt"
MLC	= "countries/Malacca.txt"
PEG	= "countries/Pegu.txt"
SST	= "countries/Shan.txt"
SUK	= "countries/Sukhothai.txt"
SUL	= "countries/Sulu.txt"
TAU	= "countries/Taungu.txt"
TOK	= "countries/Tonkin.txt"
VIE	= "countries/Vientiane.txt"

#Manchuria tags
MYR = "countries/Yeren.txt"
MHX = "countries/Haixi.txt"
MJZ = "countries/Jianzhou.txt"

#Mongol tags what are these Mongols you speak of?

#Great Tibet tags nop

#Non-Han China proper tags nop

#India is cleaned

#Others
BAR	= "countries/Bar.txt"
MSA = "countries/Malaya.txt"
HIN = "countries/Hindustan.txt"


APA = "countries/Apache.txt"
BLA = "countries/Blackfoot.txt"
CHO = "countries/Choctaw.txt"
CHY = "countries/Cheyenne.txt"
COM = "countries/Comanche.txt"
LEN = "countries/Lenape.txt"
OJI = "countries/Ojibwa.txt"
OTT = "countries/Ottawa.txt"
PEQ = "countries/Pequot.txt"
POT = "countries/Potawatomi.txt"
POW = "countries/Powhatan.txt"
SUS = "countries/Susquehannock.txt"
WCR = "countries/Cree.txt"

#Persian Additions cleansing is real

#African Additions

#Middle East Additions
ARD = "countries/Ardalan.txt"
BHT = "countries/Bohtan.txt"
ERE = "countries/Eretna.txt"
GRM = "countries/Germiyan.txt"
LEB = "countries/Lebanon.txt"
MAK = "countries/Makuria.txt"
SHM = "countries/Shammar.txt"
ARB = "countries/Arabia.txt"

#Indochina Additions
AVA = "countries/Ava.txt"
HSE = "countries/Hsenwi.txt"
JOH = "countries/Johor.txt"
LIG = "countries/Ligor.txt"
MPH = "countries/MuanPhuang.txt"
MYA = "countries/MongYang.txt"
PRK = "countries/Perak.txt"

#Siberian Tribes
CHU = "countries/Chukchi.txt"
HOD = "countries/Hodyntsy.txt"
CHV = "countries/Chavchuveny.txt"
KMC = "countries/Kamchadals.txt"
BRT = "countries/Buryats.txt"

#North American Additions
CLM = "countries/Colima.txt"
CNK = "countries/Chinook.txt"
COC = "countries/Cocomes.txt"
HDA = "countries/Haida.txt"
ITZ = "countries/Itza.txt"
KIC = "countries/Kiche.txt"
MIX = "countries/Mixtec.txt"
SAL = "countries/Salish.txt"
TLA = "countries/Tlapanec.txt"
TLX = "countries/Tlaxcala.txt"
TOT = "countries/Totonac.txt"
WIC = "countries/Wichita.txt"
XIU = "countries/Xiu.txt"

#Indonesia Additions
BLM = "countries/Blambangan.txt"
BTN = "countries/Buton.txt"
CRB = "countries/Cirebon.txt"
DMK = "countries/Demak.txt"
PGR = "countries/Pagarruyung.txt"
PSA = "countries/Pasai.txt"
SAK = "countries/Siak.txt"
LNO = "countries/Lanao.txt"
LUW = "countries/Luwu.txt"
MGD = "countries/Maguindanao.txt"
TER = "countries/Ternate.txt"
TID  = "countries/Tidore.txt"

#South American Additions
MPC = "countries/Mapuche.txt"
MCA = "countries/Muisca.txt"
PTG = "countries/Potiguara.txt"
TPQ = "countries/Tupiniquim.txt"
TPA = "countries/Tupinamba.txt"
TUA = "countries/Tapuia.txt"
GUA = "countries/Guarani.txt"
CUA = "countries/Charrua.txt"
CYA = "countries/Chachapoya.txt"
CRA = "countries/Charca.txt"
ARW = "countries/Arawak.txt"
